一一	gggg
一个月	gwee
一会	ggwf
一束	gggk
一段	ggwd
一直	ggfh
一说	ggyu
一键锁屏	gqqn
丁二酸	sfsg
七个	agwh
三周	dgmf
下单	ghul
专享	fnyk
东湖	aiid
两周	gmmf
块钱	fnqf
两城一家	gfgp
中国好声音	klvu
中国移动	kltf
中通	khce
中通快递	kcnu
么么	tctc
么么哒	ttkd
乙烷	nnop
乙醚	nnsg
九个	vtwh
买的	nurq
二个	fgwh
二合一	fwgg
二爹	fgwr
二维码	fxdc
二面角	fdqe
云存储	fdwy
云监控	fjrp
五个	ggwh
五年	ggrh
五条	ggts
亚马逊	gcbi
京东	ykai
京东快递	yanu
人事部	wguk
人性化	wnwx
什么事	wtgk
今年	wyrh
他会	wbwf
他妹	wbvf
他找	wbra
他汀类	wiod
他没说	wiyu
付钱	wfqf
代谢通路	wyck
代金券	wqud
任何事	wwgk
伊斯特	watf
会下	wfgh
会去	wffc
会玩	wfgf
会的	wfrq
会说	wfyu
传出	wfbm
低密度	wpoa
佐证	wdyg
你会	wqwf
你先	wqtf
你在	wqdh
你是	wqjg
你来	wqgo
你说	wqyu
供能	wace
侧链	wmql
做网站	wmuh
元组	fqxe
充电器	yjkk
充电宝	yjpg
充话费	yyxj
光山	igmm
八个	wtwh
公交卡	wyhg
六个	ywwh
共赢	awyn
关键词	uqyn
兼容模式	upsa
冗余	pwwg
准确率	udyx
几分钟	wwqk
几点	wthk
出发地	bnfb
函数名	boqk
分数	wvov
分析化学	wswi
刚来	mrgo
别这样	kysu
刷机	nmsw
前天	uegd
前年	uerh
力场	enfn
办公软件	ewlw
加上	ekhg
加氢	ekrn
动力学	feip
化合	wxwg
化合物	wwtq
化学品	wikk
医学部	aiuk
十个	fgwh
升学宴	tipj
华为	wxyt
华科	wxtu
单分子	uwbb
单晶	uljj
卡扣	hgrk
危房	qdyn
去哪儿	fkqt
去年	fcrh
去拿	fcwg
去看	fcrh
双系统	ctxy
反人类	rwod
取现金	bgqq
叠加包	ceqn
可汗	skif
可视化	spwx
右上	dkhg
右下	dkgh
号线	kgxf
合宜	wgpe
后盖	rgug
周一	mfgg
周三	mfdg
周丽	mfgm
周二	mffg
周五	mfgg
周六	mfyw
周六日	myjj
周四	mflh
呵呵呵	kkks
呼呼	ktkt
哪件	knwt
啥啊	kwkb
嗯嗯	klkl
四个	lhwh
四位	lhwu
四码	lhdc
回调	lkym
图们	ltwu
圆通快递	lcnu
坐公交	wwyw
坐地铁	wfqr
坐火车	wolg
坐船	wwte
基团	adlf
处理器	tgkk
处理数据	tgor
复合物	twtq
外网	qhmr
多些	qqhx
多多	qqqq
多态性	qdnt
大便	ddwg
大写	ddpg
大容	ddpw
大数据	dorn
天天向上	ggth
天天快递	ggnu
女博士	vffg
她们	vbwu
好东西	vasg
好吧	vbkc
好点	vbhk
好胜	vbet
妈蛋	vcnh
妞妞	vnvn
姨姥	vgvf
学习部长	inut
学堂	ipip
学姐	ipve
学学	ipip
学电脑	ijey
安卓	pvhj
安装步骤	puhc
宝贝儿	pmqt
审核人	psww
审核员	pskm
客座学生	poit
小分	ihwv
小木虫	isjh
小狼毫	iqyk
小米系统	iotx
尼玛	nxgc
屌丝	nkxx
山东卫视	mabp
山外有山	mqdm
工学部	aiuk
左上	dahg
帐号	mhkg
带个	gkwh
带你	gkwq
帮你	dtwq
帮我	dttr
幕墙	ajff
干嘛	fgko
年轻人	rlww
底物	oqtq
康明眼镜	ojhq
延吉	thfk
延边	thep
延边大学	tedi
开发者	gnft
开心的	gnrq
开源	gaid
开玩笑	ggtt
异构	nasq
弄一下	gggh
弄了	gabn
引号	xhkg
当前目录	iuhv
当回	ivlk
彩打	esrs
微信	tmwy
微博	tmfg
微生物学	ttti
忙完	nypf
快充	nnyc
怎么了	ttbn
怎么弄	ttga
性生活	ntit
您好	wqvb
想你	shwq
我去	trfc
我的电脑	trje
我都	trft
我问	truk
手机号	rskg
才吃	ftkt
才是	ftjg
才来	ftgo
扫一扫	rgrv
扫过	rvfp
把我	rctr
折成	rrdn
抢到	rwgc
报帐	rbmh
报错	rbqa
抱抱	rqrq
抹布	rgdm
抽中	rmkh
拉勾	ruqc
拌饭	ruqn
拿去	wgfc
排在	rhdh
排好	rhvb
控制面板	rrds
描红	raxa
搜狗	reqt
搬砖	rtdf
支付宝	fwpg
收工	nhaa
教师证	fjyg
数据线	orxf
数据表	orge
文员	yykm
易信	jqwy
易迅	jqnf
显瘦	joue
智能公交	tcwy
暖男	jele
最强大脑	jxde
有道	deut
有道词典	duym
有问题	dujg
本科生	sttg
来啦	gokr
来这儿	gyqt
松江	swia
极速模式	sgsa
构型	sqga
构象	sqqk
某一个	agwh
柚皮素	shgx
查看的	srrq
横坐标	swsf
次要	uqsv
正丁醇	gssg
正则	ghmj
正确率	gdyx
步长	hhta
武大	fhdd
武汉大学	fidi
残基	gqad
氢原子	rdbb
没了	iwbn
没事	iwgk
没事儿	igqt
没呢	iwkn
没明白	ijrr
没空	iwpw
泡脚	iqef
洗洗	itit
派克	irdq
测试中心	iykn
滑板鞋	isak
滚床单	ioul
满满	iaia
炒粉	oiow
爱奇艺	edan
牛人	tgww
狼图腾	qleu
猎豹	qteq
现场直播	gffr
珞珈	gtge
珞珈山	ggmm
理发	gjnt
生化反应	twro
生成器	tdkk
生日快乐	tjnt
生物化学	ttwi
生科院	ttbp
生说	tgyu
用些	ehhx
用以	ehny
申通快递	jcnu
电子版	jbth
电脑包	jeqn
电脑版	jeth
男的	lerq
百度	djoa
百度云	dofc
百度公交	dowy
百度地图	dofl
的话	rqyt
相互作用	sgwe
真绝	fhxq
真题	fhjg
石锅拌饭	dqrq
硬着	dgug
磨砂	osdi
科技大厦	trdd
秒杀	tirs
移动公司	tfwn
移动号	tfkg
空港	pwia
站长工具	utah
竞争关系	uqut
章颖	ujxt
等我	tftr
算了	thbn
米线	oyxf
线程	xftk
练车	xalg
组会	xewf
经济区	xiar
绪论	xfyw
网银	mrqv
羊肉煲	umwk
美美	ugug
老是	ftjg
考驾照	fejv
耗时	dijf
联发科	bntu
联系人	btww
肥牛	ectg
背单词	uuyn
能到	cegc
脂蛋白	enrr
膜蛋白	enrr
自建	thvg
自强学堂	txii
花呗	awkm
苏宁	aeps
苏晓东	ajai
药理	axgj
莲子	albb
萜类	amod
虚拟机	hrsw
虞教练	hfxa
蚂蚁花呗	jjak
行不	tgdh
行不行	tdtg
行么	tgtc
行吧	tgkc
行啊	tgkb
街道口	tukk
表嫂	geve
袖子	pubb
西南大学	sfdi
见着	mqug
触宝	qepg
试一下	yggh
试了	yabn
语音	yguj
说一声	ygfn
说是	yujg
说的	yurq
谷歌	wwsk
财付通	mwce
财务科	mttu
贴膜	mhea
赤壁	fonk
起亚	fhgo
跑男	khle
路路通	kkce
跳转	khlf
轮渡	lwio
辅导班	lngy
输入人	ltww
输入员	ltkm
过拟合	frwg
过滤器	fikk
过生日	ftjj
近些	rphx
还得	dhtj
还是	dhjg
还算	dhth
还要	dhsv
还说	dhyu
这三天	ydgd
连不上	ldhg
连着	lpug
迭代	rwwa
迭代器	rwkk
退寝	vepu
送你	udwq
选错	tfqa
逛一下	qggh
逛完	qtpf
那可	ngsk
配体	sgws
酱汤	uqin
酶号	sgkg
采购员	emkm
重启	tgyn
银行卡	qthg
锁屏	qinu
锁门	qiuy
长兴镇	tiqf
长江大桥	tids
问问	ukuk
阿里	bsjf
陪着你	buwq
雕凿	mfog
非常假期	hiwa
靶标	aksf
韵达	ujdp
顶字	sdpb
顺丰	kddh
顺丰快递	kdnu
预处理	ctgj
题典	jgma
题海	jgit
飞信	nuwy
饿了么	qbtc
高中	ykkh
高德	yktf
高德地图	ytfl
高清	ykig
魅族	rqyt
鱼豆腐	qgow
鸡蛋清	cnig
鸡蛋黄	cnam
黄酮	amsg
黄鹤楼	apso
鼠须管	eetp
